XXXXXXXXXXXXXXXXXXXXXXXXXXXXXXXXXXXXXXXXXXXXXXXXXXXXXXXXXXXXXXXXXXXXXXXXXXXXXXXXXXXXXXXXXXXXXXXXXXXXXXXXXXXXXXXXXXXXXXXXXXXXXXXXXXXXX
X###################################################################################################################################X
X###################################################################################################################################X
X###################################################################################################################################X
X###################################################################################################################################X
X###################################################################################################################################X
X###################################################################################################################################X
X###################################################################################################################################X
X###################################################################################################################################X
X###################################################################################################################################X
X###################################################################################################################################X
X###################################################################################################################################X
X###################################################################################################################################X
X###################################################################################################################################X
X###################################################################################################################################X
X###################################################################################################################################X
X###################################################################################################################################X
X###################################################################################################################################X
X###################################################################################################################################X
X###################################################################################################################################X
X##########      ###################################################################################################################X
X##########      ###################################################################################################################X
X##########      ###################################################################################################################X
X##########      ###################################################################################################################X
X##########      ###################################################################################################################X
X##########      ###################################################################################################################X
X##########      ###################################################################################################################X
X##########      ###################################################################################################################X
X##########      ###################################################################################################################X
X##########      ###################################################################################################################X
X#        #      ###################################################################################################################X
X#        #      ###################################################################################################################X
X#        #      ###################################################################################################################X
X#               ###################################################################################################################X
X#        #      ###################################################################################################################X
X#        #      ###################################################################################################################X
X#        #      ###################################################################################################################X
X##########      ###################################################################################################################X
X##########      ###################################################################################################################X
X##########      ###################################################################################################################X
X##########                                                                                                               ##########X
X##########                                                                                                               ##########X
X##########      ########################################                   ########################################################X
X##########      ########################################                   ########################################################X
X##########      ########################################                   ########################################################X
X########################################################                   ########################################################X
XXXXXXXXXXXXXXXXXXXXXXXXXXXXXXXXXXXXXXXXXXXXXXXXXXXXXXXXXXXXXXXXXX%XXXXXXXXXXXXXXXXXXXXXXXXXXXXXXXXXXXXXXXXXXXXXXXXXXXXXXXXXXXXXXXXXXv